NO assets/textures/psycodelic.png
SO assets/textures/psycodelic.png
WE assets/textures/psycodelic.png
EA assets/textures/psycodelic.png

C 220,100,0
F 225,30,0

1111111111111111111111
1000000000000000000001
1000000000000000000001
1000000000000000000001
1000000000N00000000001
1000000000000000000001
1000000111111111000001
1000000000000000000001
1000000000000000000001
1000000000000000000001
1000000000000000000001
1000000000000000000001
1111111111111111111111