NO assets/textures/misc/N.png
SO assets/textures/misc/S.png
WE assets/textures/misc/W.png
EA assets/textures/misc/E.png

C 220,100,0
F 225,30,0

111111111
100000001
1000E0001
100000001
111111111