NO assets/textures/fern/fern_north.png
SO assets/textures/fern/fern_south.png
WE assets/textures/fern/fern_west.png
EA assets/textures/fern/fern_east.png

C 122,233,255
F 100,100,100

111111111111111111
1S0000000000000001
111111111111111111