F 0,0,0


NO assets/textures/redbrick.png 

SO assets/textures/redbrick.png
WE assets/textures/redbrick.png 
EA assets/textures/redbrick.png

C 0,0,0

111111
100S01
100N01
10N001
100001
111111