F  0,0,0


SO assets/textures/redbrick.png
WE assets/textures/redbrick.png
EA assets/textures/redbrick.png

C 0,0,0

NO 

111111
100001
100001
10N001
100001
111111